########
#B     #
#      #
#   ####
#      #
#      ###############
#                    #
######################
