########
#      #
#      #
#   ####
#      #
#      ###############
#B                   #
######################
