###########################################
#########################  E  #############
#     #                 #           #     #
# ### # # ### # #  #### ### ### # ### #####
# # # # #   # # #           # # # #       #
# #          # #     ### # # # # #####  #
# #   # # # # #   # #   #   #   #       # #
# ##### # #       #                #####  #
#   #   # #   # # #   # #   # #   #   # # #
### ###                 # # # # ##### ### #
#          #    #####       #             #
# #                                     ###
# # # #   # #   # # #   # # #   #   # #   #
# #     # # # # #   #     #   #       # # #
#                         # # #### #####  #
#              ##                         #
####### B  ################################
###########################################