########
#B     ###############
#                    #
#                    #
#                    #
#                    #
#                    #
#                    #
#                    #
######################
