################
##############E#
#   #  #   #   #
# # # ## # # ###
# ###    # # # #
# #  ##### #   #
# # ##     ### #
# #          # #
# ####    ## # #
#   #      # # #
### # #### # # #
#   #  # # # # #
# #### # # # # #
#    # #   #   #
# ## # # ### ###
# #    #   #   #
#B##############
################
